##############################
#       #   #              # #
#       #    #               #
#       #     #       #      #
#       #      #             #
#       #                    #
######  #        #  #        #
#       #                    #
#   #   #   #      ###########
#           #                #
#           #                #
#     ############           #
#           #                #
#                  #         #
##############################
