##############################
#       #   #              # #
#       #    #               #
#       #     #       #      #
#       #      #             #
#                            #
######           #  #        #
#                            #
#   #       #      ###########
#           #                #
#           #                #
#     ############           #
#           #                #
#                  #         #
##############################
